NO ./textures/wall_1.xpm
SO ./textures/wall_2.xpm
WE ./textures/wall_3.xpm
EA ./textures/wall_4.xpm
S ./textures/pillar.xpm
F 0,0,0
C 256,0,255

111111111111111111111111111111111
100000000000000000000000000000001
100000000000020000000000000000001
100000100010000011110000000002001
100000100010000000010000000000001
100000100010000000010000200000001
100000111110000011110000000000001
100000000010000010000000000000001
100000000010000010000000010011111
10000000001000001111000001001
10200000000000000000000001001
100000000000000000000011110011111
100001111000000000000010000000001
100001  1000200000000010000002001
100001111000000000000000000000001
1000000000000000E0000000000000001
111111111111111111111111111111111
