NO ./textures/wall_1.xpm
SO ./textures/wall_2.xpm
WE ./textures/wall_3.xpm
EA ./textures/wall_4.xpm
S ./textures/pillar.xpm
F 100,120,140
C 125,200,255




11111111111111111111 111111111111
100000000000000000022200000000001
100000000000020000000000000000001
100000100010000011110000000002001
100000100010000000010000000000001
100000100010000000010000200000001
100000111110000011110000000000001
100000000010000010000000000000001
100000000010000010000000010011111
10000000001000001111000001001
10200000000000000000000001001
100000000000000000000011110011111
100001111000000000000010000000001
10000   1000200000000010000002001
100001111000000000000000000000001
1000000000000000N0000000000000001
111111111111111111111111111111111
